###################################
######                            <
#####                             <
##              ##                #
##              ##                #
|          ##        ##           #
|          ##        ##           #
##              ##           ##   #
##              ##           ##   #
######                       ##   #
#########                    ##   |
################################### 