###################################
############                 #    <
##########                #  #    <
#                         #  #    #
#                         #  #    |
|   #####                 #  #    #
|   ######                #       #
##  ######                #####   #
#####                         #   #
############     #            #   #
##########    #      #        #   #
###################################