###################################
########                     #    <
########                  #  #    <
#                         #  #    #
#                         #  #    |
|   ####                  #  #    #
|   ###                   #       #
##  ##                    #####   #
#####                         #   #
######                        #   #
#########                     #   #
###################################